21
21
..........#..........
..........#..........
..X.X.....#.....X.X..
...0......#......1...
..X.X.....#.....X.X..
..........#..........
.........###.........
.....................
.....................
......#.......#......
#######...9...#######
......#.......#......
.....................
.....................
.........###.........
..........#..........
..X.X.....#.....X.X..
...3......#......2...
..X.X.....#.....X.X..
..........#..........
..........#..........
